111111111111111
10C000000000C01
10C0P0010001E11
1C00C000100C101
111111111111111