111111111111111
10C000000000EC1
10C0P0010001011
1C00C000010C101
111111111111111