111111111111111
100000000000001
1000P001E000001
1C000000010C001
111111111111111