1111111111111111111111111111111
100000000000000C0000000000C0001
100000P1111111111111111111111C1
1000000100000000000C00000000101
100C000100000C0000001000E0C0101
1000000100000000C00C111111111C1
1000C0010000000000100000C000001
1111111111111111111111111111111