1111111111111111111111111111111
1000000000000000000000000000001
100000P111111111111111111111101
1000000100000000000000000000101
1000000100000C0000001000E000101
1000000100000000C00011111111101
1000000100000000001000000000001
1111111111111111111111111111111