111111111111111
10001P111111111
1000E1000000001
1C1101111111110
111111111111111