1111111
1P00001
1CC00E1
1111111