1111111111101
100000000P001
100CC00C00001
1E00C00000011
1111111111111