111111111111111
10000P111111111
1E0011000000001
1C1101111111110
111111111111111