1111111111111
100000000P001
1E0CC00C00001
1C10C00000011
1111111111111