111111111111111
10000P111111111
100011000000001
1C01E1111111110
111111111111111