11111111111111111111111111111
1P0000000C000000000C0000000C1
11111111111111111111111111101
10000000000C00000000000000101
10111111111111111111111110101
101000000C0000000000C0001C101
1C101111111111111111111C101C1
10101E0000000000C0000C0010101
101C1111111111111111111110101
1010000000C0000000000000C0101
10111111111111111111111111101
1C000000000000C0000000000C001
11111111111111111111111111111