1111111111101
100000000P001
100CC00C00001
1C10C000E0011
1111111111111